45
45
89, 89, 89, 89, 89, 89, 89, 89, 89, 89, 89, 89, 89, 89, 89, 89, 89, 89, 89, 89, 89, 89, 89, 89, 89, 89, 89, 89, 89, 89, 89, 89, 89, 89, 89, 89, 89, 89, 89, 89, 89, 89, 89, 89, 89
89, 89, 89, 89, -1, -1, -1, -1, -1, -1, -1, -1, -1, -1, -1, -1, -1, -1, -1, -1, -1, -1, -1, -1, -1, -1, -1, -1, -1, -1, -1, -1, -1, -1, -1, -1, -1, -1, 89, 89, -1, 89, -1, -1, 89
89, 89, 89, 89, -1, -1, -1, -1, -1, -1, -1, -1, -1, -1, -1, -1, -1, -1, -1, -1, -1, -1, -1, -1, -1, -1, -1, -1, -1, -1, -1, -1, -1, -1, -1, -1, -1, -1, 89, 89, -1, 89, -1, -1, 89
89, 89, 89, 89, 89, -1, -1, -1, -1, -1, -1, -1, -1, -1, -1, -1, -1, -1, -1, -1, -1, 89, 89, 89, 89, -1, -1, -1, -1, -1, -1, -1, -1, -1, -1, -1, -1, 89, 89, 89, -1, 89, -1, -1, 89
89, -1, 89, 89, 89, 89, -1, -1, -1, -1, -1, -1, -1, -1, -1, -1, -1, -1, -1, -1, -1, 89, 89, 89, 89, -1, -1, -1, -1, -1, -1, -1, -1, -1, -1, -1, 89, 89, -1, -1, 89, -1, -1, -1, 89
89, -1, -1, 89, 89, 89, -1, -1, -1, -1, -1, -1, -1, -1, -1, -1, -1, -1, -1, -1, -1, 89, 89, 89, 89, -1, -1, -1, -1, -1, -1, -1, -1, -1, -1, 89, 89, -1, -1, 89, -1, -1, -1, -1, 89
89, -1, -1, -1, 89, 89, 89, -1, -1, -1, -1, -1, -1, -1, -1, -1, -1, -1, -1, -1, -1, 89, 89, 89, 89, -1, -1, -1, -1, -1, -1, -1, -1, -1, -1, 89, 89, 89, 89, -1, -1, -1, -1, -1, 89
89, -1, -1, -1, -1, 89, 89, -1, -1, -1, -1, -1, -1, -1, -1, -1, -1, -1, -1, -1, -1, -1, -1, -1, -1, -1, -1, -1, -1, -1, -1, -1, -1, -1, -1, -1, -1, -1, -1, -1, -1, -1, -1, -1, 89
89, -1, -1, -1, -1, -1, -1, -1, -1, -1, -1, -1, -1, -1, 89, 89, 89, 89, 89, 89, 89, 89, 89, 89, 89, 89, 89, 89, 89, 89, 89, 89, -1, -1, -1, -1, -1, -1, -1, -1, -1, -1, -1, -1, 89
89, -1, -1, -1, -1, -1, -1, -1, -1, -1, -1, -1, -1, -1, 89, 89, -1, -1, -1, -1, -1, -1, -1, -1, -1, -1, -1, -1, 89, -1, -1, 89, -1, -1, -1, -1, -1, -1, -1, -1, -1, -1, -1, -1, 89
89, -1, -1, -1, -1, -1, -1, -1, -1, -1, -1, -1, -1, -1, 89, 89, -1, -1, -1, -1, -1, -1, -1, -1, -1, -1, -1, -1, 89, -1, -1, 89, -1, -1, -1, -1, -1, -1, -1, -1, -1, -1, -1, -1, 89
89, -1, -1, -1, -1, -1, -1, -1, -1, -1, -1, -1, -1, -1, 89, 89, -1, -1, -1, -1, -1, -1, -1, -1, -1, -1, -1, -1, 89, -1, -1, 89, -1, -1, -1, -1, -1, -1, -1, -1, -1, -1, -1, -1, 89
89, -1, -1, -1, -1, -1, -1, -1, -1, -1, -1, -1, -1, -1, 89, 89, -1, -1, -1, -1, -1, -1, -1, -1, -1, -1, -1, -1, 89, -1, -1, 89, -1, -1, -1, -1, -1, -1, -1, -1, -1, -1, -1, -1, 89
89, -1, -1, -1, -1, -1, -1, -1, -1, -1, -1, -1, -1, -1, 89, 89, 89, -1, -1, -1, -1, -1, -1, -1, -1, -1, -1, -1, 89, -1, -1, 89, -1, -1, -1, -1, -1, -1, -1, -1, -1, -1, -1, -1, 89
89, -1, -1, -1, -1, -1, -1, -1, -1, -1, -1, -1, -1, -1, 89, 89, -1, -1, -1, -1, -1, -1, -1, -1, -1, -1, -1, -1, 89, -1, -1, 89, -1, -1, -1, -1, -1, -1, -1, -1, -1, -1, -1, -1, 89
89, -1, -1, -1, -1, -1, -1, -1, -1, -1, -1, -1, -1, -1, 89, 89, -1, -1, -1, -1, -1, -1, -1, -1, -1, -1, -1, -1, 89, -1, -1, 89, -1, -1, -1, -1, -1, -1, -1, -1, -1, -1, -1, -1, 89
89, -1, -1, -1, -1, -1, -1, -1, -1, -1, -1, -1, -1, -1, 89, 89, -1, -1, -1, -1, -1, -1, -1, -1, -1, -1, -1, -1, 89, -1, -1, 89, -1, -1, -1, -1, -1, -1, -1, -1, -1, -1, -1, -1, 89
89, -1, -1, -1, -1, -1, -1, -1, -1, -1, -1, -1, -1, -1, 89, 89, -1, -1, -1, -1, -1, -1, -1, -1, -1, -1, -1, -1, 89, -1, -1, 89, -1, -1, -1, -1, -1, -1, -1, -1, -1, -1, -1, -1, 89
89, -1, -1, -1, -1, -1, -1, -1, -1, -1, -1, -1, -1, -1, 89, 89, -1, -1, -1, -1, -1, -1, -1, -1, -1, -1, -1, -1, 89, -1, -1, 89, -1, -1, -1, -1, -1, -1, -1, -1, -1, -1, -1, -1, 89
89, -1, -1, -1, 89, 89, 89, 89, -1, -1, -1, -1, -1, -1, 89, 89, -1, -1, -1, -1, -1, -1, -1, -1, -1, -1, -1, -1, 89, -1, -1, 89, -1, -1, -1, -1, -1, -1, -1, -1, -1, -1, -1, -1, 89
89, -1, -1, -1, 89, 89, 89, 89, -1, -1, -1, -1, -1, -1, 89, 89, -1, -1, -1, -1, -1, -1, -1, -1, -1, -1, -1, -1, 89, -1, -1, 89, -1, -1, -1, -1, -1, 89, 89, 89, 89, -1, -1, -1, 89
89, -1, -1, -1, 89, 89, 89, 89, -1, -1, -1, -1, -1, -1, 89, 89, -1, -1, -1, -1, -1, -1, -1, -1, -1, -1, -1, -1, 89, -1, -1, 89, -1, -1, -1, -1, -1, 89, 89, 89, 89, -1, -1, -1, 89
89, -1, -1, -1, 89, 89, 89, 89, -1, -1, -1, -1, -1, -1, 89, 89, -1, -1, -1, -1, -1, -1, -1, -1, -1, -1, -1, -1, 89, -1, -1, 89, -1, -1, -1, -1, -1, 89, 89, 89, 89, -1, -1, -1, 89
89, -1, -1, -1, -1, -1, -1, -1, -1, -1, -1, -1, -1, -1, 89, 89, -1, -1, -1, -1, -1, -1, -1, -1, -1, -1, -1, -1, 89, -1, -1, 89, -1, -1, -1, -1, -1, 89, 89, 89, 89, -1, -1, -1, 89
89, -1, -1, -1, -1, -1, -1, -1, -1, -1, -1, -1, -1, -1, 89, 89, -1, -1, -1, -1, -1, -1, -1, -1, -1, -1, -1, -1, 89, -1, -1, 89, -1, -1, -1, -1, -1, -1, -1, -1, -1, -1, -1, -1, 89
89, -1, -1, -1, -1, -1, -1, -1, -1, -1, -1, -1, -1, -1, 89, 89, -1, -1, -1, -1, -1, -1, -1, -1, -1, -1, -1, -1, 89, -1, -1, 89, -1, -1, -1, -1, -1, -1, -1, -1, -1, -1, 89, 89, 89
89, -1, -1, -1, -1, -1, -1, -1, -1, -1, -1, -1, -1, -1, 89, 89, -1, -1, -1, -1, -1, -1, -1, -1, -1, -1, -1, -1, 89, -1, -1, 89, -1, -1, -1, -1, -1, -1, -1, -1, -1, 89, 89, 89, 89
89, 89, -1, -1, -1, -1, -1, -1, -1, -1, -1, -1, -1, -1, 89, 89, -1, -1, -1, -1, -1, -1, -1, -1, -1, -1, -1, -1, 89, -1, -1, 89, -1, -1, -1, -1, -1, -1, -1, -1, 89, 89, 89, 89, 89
89, 89, 89, -1, -1, -1, -1, -1, -1, -1, -1, -1, -1, -1, 89, 89, -1, -1, -1, -1, -1, -1, -1, -1, -1, -1, -1, -1, 89, -1, -1, 89, -1, -1, -1, -1, -1, -1, 89, 89, 89, 89, 89, 89, 89
89, 89, 89, 89, 89, -1, -1, -1, -1, -1, -1, -1, -1, -1, 89, 89, -1, -1, -1, -1, -1, -1, -1, -1, -1, -1, -1, -1, 89, -1, -1, 89, -1, -1, -1, -1, -1, -1, 89, 89, 89, -1, 89, -1, 89
89, 89, 89, 89, 89, 89, 89, -1, -1, -1, -1, -1, -1, -1, 89, 89, 89, 89, 89, 89, 89, 89, 89, 89, 89, 89, 89, 89, 89, 89, 89, 89, -1, -1, -1, -1, -1, -1, 89, 89, 89, 89, -1, -1, 89
89, -1, -1, 89, 89, 89, 89, -1, -1, -1, -1, -1, -1, -1, -1, -1, -1, -1, -1, -1, -1, -1, -1, -1, -1, -1, -1, -1, -1, -1, -1, -1, -1, -1, -1, -1, -1, -1, -1, -1, -1, -1, -1, -1, 89
89, -1, -1, -1, -1, -1, -1, -1, -1, -1, -1, -1, -1, -1, -1, -1, -1, -1, -1, -1, -1, -1, -1, -1, -1, -1, -1, -1, -1, -1, -1, -1, -1, -1, -1, -1, -1, -1, -1, -1, -1, -1, -1, -1, 89
89, -1, -1, -1, -1, -1, -1, -1, -1, -1, -1, -1, -1, -1, -1, -1, -1, -1, -1, -1, -1, -1, -1, -1, -1, -1, -1, -1, -1, -1, -1, -1, -1, -1, -1, -1, -1, -1, -1, -1, -1, -1, -1, -1, 89
89, -1, -1, -1, -1, -1, -1, -1, -1, -1, -1, -1, -1, -1, -1, -1, -1, -1, -1, -1, -1, -1, -1, -1, -1, -1, -1, -1, -1, -1, -1, -1, -1, -1, -1, -1, -1, -1, -1, -1, -1, -1, -1, -1, 89
89, -1, -1, -1, -1, -1, -1, -1, -1, -1, -1, -1, -1, -1, -1, -1, -1, -1, -1, -1, -1, 89, 89, 89, 89, -1, -1, -1, -1, -1, -1, -1, -1, -1, -1, -1, -1, -1, -1, -1, -1, -1, -1, -1, 89
89, -1, -1, -1, -1, -1, -1, -1, -1, 89, 89, -1, -1, -1, -1, -1, -1, -1, -1, -1, -1, 89, 89, 89, 89, -1, -1, -1, -1, -1, -1, -1, -1, 89, 89, -1, -1, -1, -1, -1, -1, -1, -1, -1, 89
89, -1, -1, -1, -1, -1, -1, -1, 89, -1, 89, -1, -1, -1, -1, -1, -1, -1, -1, -1, -1, 89, 89, 89, 89, -1, -1, -1, -1, -1, -1, -1, -1, 89, 89, -1, -1, -1, -1, -1, -1, -1, -1, -1, 89
89, -1, -1, -1, -1, -1, -1, 89, -1, 89, -1, -1, -1, -1, -1, -1, -1, -1, -1, -1, -1, 89, 89, 89, 89, -1, -1, -1, -1, -1, -1, -1, -1, -1, 89, -1, -1, -1, -1, -1, -1, -1, -1, -1, 89
89, -1, -1, -1, -1, -1, 89, -1, 89, -1, -1, -1, -1, -1, -1, -1, -1, -1, -1, -1, -1, -1, -1, -1, -1, -1, -1, -1, -1, -1, -1, -1, -1, -1, 89, 89, 89, -1, -1, -1, -1, -1, -1, -1, 89
89, -1, -1, -1, -1, -1, 89, 89, 89, -1, -1, -1, -1, -1, -1, -1, -1, -1, -1, -1, -1, -1, -1, -1, -1, -1, -1, -1, -1, -1, -1, -1, -1, -1, 89, 89, 89, -1, -1, -1, -1, -1, -1, -1, 89
89, -1, -1, -1, -1, 89, 89, 89, -1, -1, -1, -1, -1, -1, -1, -1, -1, -1, -1, -1, -1, -1, -1, -1, -1, -1, -1, -1, -1, -1, -1, -1, -1, -1, 89, 89, 89, 89, -1, -1, -1, -1, -1, -1, 89
89, -1, -1, -1, -1, 89, 89, 89, -1, -1, -1, -1, -1, -1, -1, -1, -1, -1, -1, -1, -1, -1, -1, -1, -1, -1, -1, -1, -1, -1, -1, -1, -1, -1, -1, 89, 89, 89, -1, -1, -1, -1, -1, -1, 89
89, 89, 89, 89, 89, 89, 89, 89, 89, 89, 89, 89, 89, 89, 89, 89, 89, 89, 89, 89, 89, 89, 89, 89, 89, 89, 89, 89, 89, 89, 89, 89, 89, 89, 89, 89, 89, 89, 89, 89, 89, 89, 89, 89, 89
89, 89, 89, 89, 89, 89, 89, 89, 89, 89, 89, 89, 89, 89, 89, 89, 89, 89, 89, 89, 89, 89, 89, 89, 89, 89, 89, 89, 89, 89, 89, 89, 89, 89, 89, 89, 89, 89, 89, 89, 89, 89, 89, 89, 89